WWWWWWWW0
W0000000W
000000000
W0000000W
0000000W0
W000000WW
000WWWW00
W00WWW0WW
000WW00W0
W000000WW
000000WW0
W00000WWW
W0000WWW0
WW00WWWWW
WWWW0WWW0
WWWWWWWWW
WWWWWWWW0
