WWWWWWWW0
WWWWWWWWW
WWWWWWWW0
WWWW0WWWW
WWW00WWW0
WWW000WWW
WW0000WW0
WWW000000
WWW000WW0
WWWW00WWW
WWWWWWWW0
WWWWWWWWW
WWWWWWWW0
WWWWWWWWW
WWWWWWWW0
WWWWWWWWW
WWWWWWWW0
